0--------------------0
|                    |
| |--| | ---- | |--| |
| |  | |      | |  | |
| |--| |      | |--| |
|      | |--| |      |
| -----| |--| |----- |
| |                | |
| |    ---  ---    | |
|       HSSS         |
| ------ |--| ------ |
|        |--|        |
| |--| |      | |--| |
| |  | |      | |  | |
| |--| |      | |--| |
|      | |--| |      |
| -----| |--| |----- |
|                    |
0--------------------0
