0-----------------0
|        0        |
| 00 000 0 000 00 |
|                 |
| 00 0 00000 0 00 |
|    0   0   0    |
|--- 000 0 000 ---|
|00| 0   M   0 |00|
|--- 0 0- -0 0 ---|
G      |   |      G
|--- 0 ----- 0 ---|
|00| 0   P   0 |00|
|--- 0 00000 0 ---|
|        0        |
| 00 000 0 000 00 |
|  0           0  |
|0 0 0 00000 0 0 0|
|    0   0   0    |
| 000000 0 000000 |
|                 |
0-----------------0