000000000000000000000
00-----------------00
0|S       0       S|0
0| 00 000 0 000 00 |0
0|                 |0
0| 00 0 00000 0 00 |0
0|    0   0   0    |0
0|--- 000 0 000 ---|0
0|00| 0   M   0 |00|0
0|--- 0 0- -0 0 ---|0
0G      |MMM|      G0
0|--- 0 ----- 0 ---|0
0|00| 0   P   0 |00|0
0|--- 0 00000 0 ---|0
0|        0        |0
0| 00 000 0 000 00 |0
0|  0           0  |0
0|0 0 0 00000 0 0 0|0
0|    0   0   0    |0
0| 000000 0 000000 |0
0|S               S|0
00-----------------00
000000000000000000000